11111
10P01
10001
10001
10001
100P1
11111