11111
10P01
10101
11001
10101
1C0E1
11111