1111111111111
1C0100C000001
1000011111P01
1C00110E0C0C1
1111111111111
